; This map is generated using mapmaker v1.0-alpha

1 111111111111111111111111111111111111111111111111111111111111111111111111111111111111111111111111111111111111111111111111
1 100000000000000000000000000000000000000000000000000000000000100000000000000000000000000000150000000000000000000000000001
1 100000000000000000000000000000000000000000000000000000000000100000000000000000000000000000100000000000000000000000000001
1 100111111111111111111111111111111111111111111111111111111100100000000000000000000000000000111111111111111111111111111001
1 100100000000000000000000000000000000000000000000000000000100100000000000000000000000000000100000000000000000000000001001
1 100100000000000000000000000000000000000000000000000000000100100000000000000000000000000000100000000000000000000000001001
1 100100000000000000000000000000000000000000000000000000000000000000000000000000000000000000100000000000000000000000000001
1 100100000000000000000000000000000000000000000001111100000000000000111110000000000000000000100000000000000000000000000001
1 100100000000000000000000000000000000000000000001111100000000000000111110000000000000000000100000000000000000000000001111
1 100100000000000000000000000000000000000000000001111100000000000000111110000000000000000000100000000000000000000000000001
1 100100000000000000000000000000000000000000000001111100000000000000111110000000000000000000100000000000000000000000000001
1 100100000000000000000000000000000000000000000000000000000000000000000000000000000000000000100000000000000000000000000001
1 100100000000000000000000000000000000000000000000000000000000000000000000000000000000000000100000000000000000000000001001
1 100100000000000000000000000000000000000000000000000000000000000000000000000000000000000000100000000000000000000000001001
1 100100000000000000000000000000000000000000000000000000000000000000000000000000000000000000100000000000000000000000001001
1 100100000000000000000000000000000000000000000000000000000000000000000000000000000000000000100000000000000000000000001001
1 100100000000000000000000000000000000000000000000000000000000000000000000000000000000000000100000000000000000000000001001
1 100100000000001111111000000000000000000000000000000001000000000000000000000000000000000000100000000000000000000000001001
1 100100000000001000001001000000000000000000000000000010000000000000000000000000000000000000100000000000000000000000001001
1 100100000000001000001001000000000000000000000000000100000000000000000000000000000000000000100000000000000000000000001001
1 100100000000001001001001000000000000000000000000001000000000010000000000100000000000000000100000000000000000000000001001
1 100100000000001001001001000000000000000000000000000000000000111000000000010000000000000000100000000000000000000000001001
1 100100000000001001001001000000000000000000000000000000000001111100000000001000000000000000100000000000000000000000001001
1 100100000000001001001001000000000000000000000000000000000011111110000000000100000000000000100000000000000000000000001001
1 100100000000001001001001000000000000000000000000000000000111111111000000000000000000000000100000000000000000000000001001
1 100100000000001021001001000000000000000000000000000000001111111111100000000000000000000000100000000000000000000000001001
1 100100000000001001001001000000000000000000000000000000011111000111110000000000000000000000100000000000000000000000001001
1 100100000000001001001001000000000000000000000000000000111100000001111000000000000000000000100000000000000000000000001001
1 100100000000001001000001000000000000000000000000000001110000000000011100000000000000000000100000000000000000000000001001
1 100100000000001001000001000000000000000000000000000011000000000000000110000000000000000000111111111111100111111111111001
1 100111111111111001111111111111100000000000000000000000000000000000000000000000000000000000000000100000100100000000001001
1 100100000000000000000000000000100000000000000000000011000000000000000110000000000000000000000000100000100100000000001001
1 100100000000000000000000000000100000000000000000000001110000000000011100000000000000000000000000100100100100000000001001
1 100100000000000000000000000000100000000000000000000000111100000001111000000000000000000000000000100100100100000000001001
1 100100000000000000000000000000100000000000000000000000011111000111110000000000000000000000000000100100130100000000001001
1 100100000000000000000000000000100000000000000000000000001111111111100000000000000000000000000000100100100100000000001001
1 100100000000000000000000000000100000000000000010000000000111111111000000000000000000000000000000100100100100000000001001
1 100100000000000000000000000000100000000000000001000000000011111110000000000000000000000000000000100100100100000000001001
1 100100000000000000000000000000100000000000000000100000000001111100000000000010000000000000000000100100100100000000001001
1 100100000000000000000000000000100000000000000000010000000000111000000000000100000000000000000000100100100100000000001001
1 100100000000000000000000000000100000000000000000000000000000010000000000001000000000000000000000100100000100000000001001
1 100100000000000000000000000000100000000000000000000000000000000000000000010000000000000000000000100100000100000000001001
1 100100000000000000000000000000100000000000000000000000000000000000000000000000000000000000000000000111111100000000001001
1 100100000000000000000000000000100000000000000000000000000000000000000000000000000000000000000000000000000000000000001001
1 100100000000000000000000000000100000000000000000000000000000000000000000000000000000000000000000000000000000000000001001
1 100100000000000000000000000000100000000000000000000000000000000000000000000000000000000000000000000000000000000000001001
1 100100000000000000000000000000100000000000000000000000000000000000000000000000000000000000000000000000000000000000001001
1 100100000000000000000000000000100000000000000000000000000000000000000000000000000000000000000000000000000000000000001001
1 100100000000000000000000000000100000000000000000000000000000000000000000000000000000000000000000000000000000000000001001
1 100100000000000000000000000000100000000000000000000000000000000000000000111110000000000000000000000000000000000000001001
1 100000000000000000000000000000100000000000000001111100000000000000000000111110000000000000000000000000000000000000001001
1 100000000000000000000000000000100000000000000001111100000000000000000000111110000000000000000000000000000000000000001001
1 100000000000000000000000000000100000000000000001111100000000000000000000111110000000000000000000000000000000000000001001
1 111100000000000000000000000000100000000000000001111100000000000000000000000000000000000000000000000000000000000000001001
1 100000000000000000000000000000100000000000000000000000000000100100000000000000000000000000000000000000000000000000001001
1 100000000000000000000000000000100000000000000000000000000000100100000000000000000000000000000000000000000000000000001001
1 100111111111111111111111111111100000000000000000000000000000100111111111111111111111111111111111111111111111111111111001
1 100000000000000000000000000000100000000000000000000000000000100000000000000000000000000000000000000000000000000000000001
1 100000000000000000000000000004100000000000000000000000000000100000000000000000000000000000000000000000000000000000000001
1 111111111111111111111111111111111111111111111111111111111111111111111111111111111111111111111111111111111111111111111111
2 20

3 2 158 655 base_gfx.dat
3 1 727 156 base_gfx.dat
3 0 1599 789 base_gfx.dat
3 2 2037 136 base_gfx.dat
3 0 424 1001 base_gfx.dat
3 0 1118 533 base_gfx.dat
