; default map by TriGen
; x, y: 30, 20 blocks
1 111111111111111111111111111111
1 102000000000000000000000000001
1 100000000000000000000000000001
1 100001111111111111111111100001
1 100001400000000000000000100001
1 100001000000000000000000100001
1 100001000000000000000000100001
1 100001000000000000000000100001
1 100000000000001100000000000001
1 100000000000001100000000000001
1 100000000000001100000000000001
1 100000000000001100000000000001
1 100001000000000000000000100001
1 100001000000000000000000100001
1 100001000000000000000000100001
1 100001000000000000000005100001
1 100001111111111111111111100001
1 100000000000000000000000000001
1 100000000000000000000000000301
1 111111111111111111111111111111

; 2 = Red team spawn location
; 3 = Blue team spawn location
; 4 = Red flag
; 5 = Blue flag

; block size in pixels (height/width in pixels
; will be calculated using this value)
2 20

; MAP HEIGHT in pixels: 30 * 20 = 400
; MAP WIDTH in pixels: 20 * 20 = 600
