; default map by TriGen
; x, y: 30, 20 blocks
000000000000000000000000000000
000000000000000000000000000000
000000000000000000000000000000
000001111111111111111111100000
000001000000000000000000100000
000001000000000000000000100000
000001000000000000000000100000
000001000000000000000000100000
000000000000001100000000000000
000000000000001100000000000000
000000000000001100000000000000
000000000000001100000000000000
000001000000000000000000100000
000001000000000000000000100000
000001000000000000000000100000
000001000000000000000000100000
000001111111111111111111100000
000000000000000000000000000000
000000000000000000000000000000
000000000000000000000000000000
; block size in pixels (height/width in pixels 
; will be calculated using this value)
2 20

; MAP HEIGHT in pixels: 30 * 20 = 400
; MAP WIDTH in pixels: 20 * 20 = 600
