; This map is generated using mapmaker v1.0-alpha

1 111111111111111111111111111111
1 100000000000000000000000000001
1 100000000000010000011111000001
1 100010000000001000100000000001
1 100011100001111111110000000001
1 100000011011000000011100000001
1 102004001110000000000110500001
1 100000000100000000000010000001
1 100000000100100000100011000001
1 100000000100100000100001000001
1 100000000100000000000001000001
1 100000000100000000000011000301
1 100000000011000000000010000001
1 100000000001100000000110000001
1 100000000000111000011100000001
1 100000000000001111110000000001
1 100000000000000000000000000001
1 100000000000000000000000000001
1 100000000000000000000000000001
1 111111111111111111111111111111
2 20

3 0 8 3 base_gfx.dat
3 1 433 228 base_gfx.dat
3 2 12 168 base_gfx.dat
