; This map is generated using mapmaker v1.0-alpha

1 111111111111111111111111111111111111111111111111111111111111
1 100000000000000000000000000000000000000000000000000000000001
1 100000000000010000011111000000000000000000000000000000000001
1 100010000000001000100000000000000000000000000010000000000001
1 100011100001111111110000000000000000000000000000000000001001
1 100000011011000000011100000000010000000000000000000000000001
1 102004001110000000000110500000010000000000000000001000000001
1 100000000100000000000010000000010000000000000000000000000001
1 100000000100100000100011000000010000000001000000000000000001
1 100000000100100000100001000000010000000000000000000000000001
1 100000000100000000000001000000010000000000000000000100000001
1 100000000100000000000011000300010000000000000000011100000001
1 100000000011000000000010000000010000000000000111100100000001
1 100000000001100000000110000000010000000000111100000100000001
1 100000000000111000011100000000010000000111100000000100000001
1 100000000000001111110000000000010000111000000000000100000001
1 100011110000000000000000000000010111100000000000000100000001
1 100010010000000000000000000000010100000000000111000100000001
1 100010010000000000000000000000010100000000000101000100000001
1 000011110000000000000011111111110100011110000101000100000000
1 000000000000000000000000000000000100010010000111000100000000
1 000000000000111110000000000000000100010010000000000100000000
1 000000000001110011100000001111100100010110000000001100000000
1 000000000010000000011000001000110100011100000000011000000000
1 100000000110000000001000001000010100000000000000100000000001
1 100000000100000000000100001011110100000000000111000000000001
1 100000000100000000000100000110000100000000111000000000000001
1 100000000100000000000100000000000100001111100000000000100001
1 100000000100000000000110000000000101110000000000000000000001
1 100000000100000000000010000000000111000000000000001000000001
1 100000000110000000000110000000000100000000000000000000000001
1 100000000010000000000100000000000000000000000000000001000001
1 100000000011000000000100000000000000000000000000000010000001
1 100000000001000000011000000000000000000000000000000000000001
1 100000000000110001110000000000000000000000000000000000000001
1 100000000000011111000000000000000000000000000010000000000001
1 100000000000000000000000000000000000000000000000000001000001
1 100000000000000000000000000000000000000000000000000000000001
1 100000000000000000000000000000000000000000000000000000000001
1 111111111111111111111111111111111111111111111111111111111111
2 20

3 0 28 172 base_gfx.dat
3 2 467 553 base_gfx.dat
3 1 640 25 base_gfx.dat
3 1 -48 637 base_gfx.dat
3 0 835 241 base_gfx.dat
3 0 1060 647 base_gfx.dat
