; This map is generated using mapmaker v1.0-alpha

1 111111111111111111111111111111111111000011111111111111111111
1 100000000000000000000000001000000000000000000000000000000001
1 100000001000000000100000001000000000000000000000000000000001
1 100000001102000000100000001000000000000000001000001000000001
1 100000000100000000110000001000000001100000000000000000000001
1 100000000110000000011000001000000011000000000000000000000001
1 100000000011000000001100000000000000000000000000000000000001
1 100000030000000000000000010001000100000000000000000001000101
1 100000000000000100100000010001000100111111110001010001000101
1 100000000000000100010000110001000111000000000001000001000001
1 100000000001000100010100000001000100000000000010000001000001
1 100000001111000100000000000001000100100000000100000110000001
1 100001111000000100000000100001000100000000000101111100000001
1 100011000000000100000000100001000100000000011000001000110001
1 111000011111111111111111111111111100000000100000001000000001
1 100000000001000100000001000000000100000011000000001100000001
1 100000000001000000000001000000000010000110000000000111010001
1 100000000000000000000001000000000010001000000001000100000001
1 100000000000000000000001000000000110000000000000000000000001
1 100000000000000000000001000000000110000010000000000000000001
1 100000000000000000000001000000000110000000000000000001000001
1 100000000000000000000001000000001111111000000000000000000001
1 110000000000000000000001000000000000000000000000000000400001
1 110000000000000000000000000000000000000000000000000000000001
1 110000000001000000000000000000000000000000000000000000000001
1 110000000001000000000000000000000000000010000010000050000001
1 110000000001000000000000000000000000000000000000000000000001
1 110000000001000000000000000000000001000010000000000000000011
1 110000000001000000000000000000000001000010000000000000000111
1 111111111111111111111111111111111111000011111111111111111111
2 20

3 2 82 21 base_gfx.dat
